############################
#NNNNNNNNN##NNNN##NNNNNNNNN#
#N####N##N##N##N##N##N####N#
#N####N##N##N##N##N##N####N#
#N####N##N##N##N##N##N####N#
#NNNNNN##NNNN##NNNN##NNNNNN#
#N##N####N########N####N##N#
#N##N####N########N####N##N#
#N##NNNNNNNNNNNNNNNNNNNN##N#
#N####N##N########N##N####N#
#N####N##N########N##N####N#
#NNNNNN##NNNNNNNNNN##NNNNNN#
#N#######N###GG###N#######N#
#N#######N#GGGGGG#N#######N#
#NNNNNNNNN#GGGGGG#NNNNNNNNN#
#N####N##N#GGGGGG#N##N####N#
#N####N##N########N##N####N#
#NNN##N##NNNNNNNNNN##N##NNN#
###N##N#####N##N#####N##N###
###N##N#####N##N#####N##N###
#NNNNNNNNNNNN##NNNNNNNNNNNN#
#N####N##N########N##N####N#
#N####N##N########N##N####N#
#NNNNNN##NNNNNNNNNN##NNNNNN#
###N##N#####N##N#####N##N###
###N##N#####N##N#####N##N###
#NNN##N##NNNN##NNNN##N##NNN#
#N####N##N########N##N####N#
#N####N##N########N##N####N#
#NNNNNNNNNNNNNNNNNNNNNNNNNN#
############################