#######
#NNNNN#
#N#G#N#
#N#G#N#
#N#G#N#
#N#G#N#
#N#G#N#
#N#G#N#
#N#G#N#
#N#G#N#
#N###N#
#NNNNN#
#######