###########
#NNNN#NNNN#
#N##N#N##N#
#N#NNNNN#N#
#N#NGGGN#N#
#N#N###NNN#
#N#N###N#N#
#N#NNNNN#N#
#N##N#N##N#
#NNNN#NNNN#
###########