######
#NNNN#
#N##N#
#N##N#
#N##N#
#N##N#
#N##N#
#N##N#
#N#GN#
#N#GN#
#NG#N#
#NG#N#
#NNNN#
######